1111111111111
100C000000111
1010101000011
1010101000C01
1C1E1P1110001
1111111111111