11111111111111111
1E000000000000T01
101C1010101010101
10000000000000001
101C1C10101010101
10000000000T00001
10101010101010101
10000T00000000001
10101010101010101
10000000000000001
10101010101010101
1T0000000000000P1
11111111111111111