1111111111
1T01E1C111
1001C00011
1000000C11
10001101C1
1T00000001
1C0101C011
1100011011
1C01011P11
1111111111