11111
1E1P1
10101
10101
101C1
10101
10001
1C0C1
10001
1C001
100T1
11111