1111111111111111111
1T0C1T00E000011C011
1011100C00011100101
10010C11110000T0001
1001100T00011101111
1C00001000101000001
10011110101010C1111
10100T0000100000001
1P0000011C001T00C01
1111111111111111111