11111111111111111111111
11111110011E11111101011
11111111000010111111111
11111100011010011110001
10000001111011000110101
10111110111011010000101
10010010111110010111001
110C0110100000000111011
11110000001101111111P11
11111111111111111111111