11111111
111EE111
10000001
10000001
1000C001
1111P111
11111111