1111111111111111
1T1111E111110001
1011110100010101
1011111100010101
1000000101110101
1001110101T10101
1011C10111010101
1011T10000000101
1111011111111101
1P00000CCCC00001
1111111111111111