111111111
10C000C01
1000T0001
100TET001
1000T0001
1PC000C01
111111111