1111
1E11
1011
1111
1011
10C1
1CP1
1111