11111
1E1P1
10101
10101
101C1
10101
10001
1T001
11111