11111111111111111
10000000000000001
10111111T11111101
10100000000000101
10101111111E10101
10101111111C10101
101T0000000010101
1011111T111110101
100000000000001P1
11111111111111111