1111111111111111111
111111111E111111111
1111111110111111111
11111T0000000T11111
1111101110111011111
1111101110111011111
1C0000000P0000000C1
1111101110111011111
1111101110111011111
11111T0000000T11111
1111111110111111111
111111111C111111111
1111111111111111111