1111
1E11
1001
1101
10C1
1011
1C01
1101
1001
1011
1001
1CP1
1111