11111111
111E11T1
11101101
10C00001
10101101
10101101
101000C1
10T11101
10001101
10000001
1C1110C1
1T111P11
11111111