11111111111111111
1E0T0000000000001
101C1T1010101C101
1T000000000000001
10101C1T101C10101
1T000000000000001
1010101C1C1010101
1T000000000000001
10101C10101C10101
1T000000000000001
101C1010101T1C101
1T0000000000000P1
11111111111111111