11111111111111111
11111110011E11111
11111111000010111
11111100011010011
1T000C01111011T11
10111010111011011
1C010010111110011
110C0110100000CP1
11110000001101111
11111111111111111