1111111111
1111E11111
1111C00011
1000001C11
10111111C1
1011C00001
1C01011011
1100011011
1C01111P11
1111111111