111111111111
111111000TC1
100000000001
101111111111
100000000001
111111111101
100000000001
1011T1111111
1PE111111111
111111111111