11111111111
11111E11111
1CCCCCCCCC1
1CCCCCCCCC1
1CCCCCCCCC1
1CCCCCCCCC1
11111011111
11111011111
11111P11111
11111111111