1111111111111
1001000000TC1
1000011111001
1P0011E000001
100T000011101
1001111111001
1111111111111