1111111111111111
100C000110111101
1T1111C110111101
1011110100010101
10000001C1T10001
1011010111011101
1C11C1000000E101
1111T11111111101
1P00000CCCC00001
1111111111111111