11111111111111111111
11T111T11T1T11T1T111
1100C000000000000C11
11000000000C000000T1
1T0000C0000000000011
110C00000000000C00E1
1T000000000000000011
110000000P00000C00T1
1T0000C0000000000011
110C000000C0000000T1
11000000000000000CT1
110000C000000C000011
110C000000C0000C00T1
11T1T1TT1T11T11T1T11
11111111111111111111