11111111
111E11T1
11101101
10C01001
10101111
10101111
101000C1
10T11111
10001111
10000001
1C1110C1
1T111P11
11111111