111111111111111
11111E111111111
11111P111111111
11111C111111111
111111111111111
111111111111111
111111111111111