11111111111
101100101E1
1000000C001
11111C01011
10000011011
10111111011
1T000C0C0C1
110111100C1
11000010011
1C000T10P01
11111111111