11111111111111111111111111111111111
100C00000000000000000000000001E1001
10000000000000000000000000000111001
10000000000000000000000000000000001
10000000000000000000000000000000001
10000000000000000000000000000000001
10000000000000000000000000000000001
10000000000000000000000000000000001
10P00000000000000000000000000000001
11111111111111111111111111111111111