1111111111
1111E11111
111CCCC111
1CCCCCCC11
1C1C1C1C11
1P11111111
1111111111