1111111111111111111
100C0000000000E1001
1000000000000000001
1000000000000000001
1000000000000000001
1000000000000000001
1000000000000000001
1000000000000000001
10P0000000000000001
1111111111111111111