1111
1E11
1001
1101
1001
10C1
1CP1
1111