11111111111111111
111E110000011C0T1
11101001110C00111
10C01001111100011
1010110100C100111
10101101000110111
101000C1110110101
10T111110001100C1
10001111000110111
10000000011110111
1C1110C1001C00001
1T111P1111111C111
11111111111111111