11111111111111111111111
100C00000000000000E0001
10000000000000000000001
10000000000000000000001
10000000000000000000001
10000000000000000000001
10000000000000000000001
10000000000000000000001
10P00000000000000000001
11111111111111111111111