111111111111
111111000001
11T111111111
111000000001
110011111111
110011111E11
100000000001
101010101011
1P1C1T1C1T11
111111111111