111111111111111
1T111E111111111
1011101T0010001
10111P101000101
1C011C100111101
110110110111101
11000000010T0C1
111111111111111